                  
. - . - . @ S - . 
| ■ | O | O | ■ | 
. - . - . ⬢ . - . 
| O | O | O | O | 
. - . - . - . - . 
| O | O | ⯍ | ■ @ 
. - . - . - . - . 
| O | □ | O | O | 
. - . - E - . - . 
                  
