              
. - . - S - . 
| ⯍ | ⯍ | O | 
. - . - . - . 
| ⯍ | ⯍ | O | 
. - . - . - . 
| O | ⯍ | ⯍ | 
. - . @ E - . 
              
