              
. - . - S - . 
| ■ | ■ @ O | 
. - . - . - . 
| O @ ⯍ | ■ @ 
. - . - ⬢ @ . 
| □ | O | O | 
. - E - . - . 
              
